﻿..................................
..................................
..................................
..................................
..................................
...########...#####...##########..
...#............#.........#.......
...#............#.........#.......
...#............#.........#.......
...########.....#.........#.......
...#............#.........#.......
...#............#.........#.......
...#............#.........#.......
...#............#.........#.......
...#.........#######......#.......
..................................
..................................
..................................
..................................
..................................
..................................
..................................
..................................
..................................
..................................
..................................
..................................
..................................
..................................
..................................
..................................
..................................
..................................
..................................
..................................