﻿..................................
..................................
..................................
..................................
..................................
...#......#.....###########.......
...#.....#......#.................
...#...#........#.................
...#.#..........#.................
...##...........#.................
...#.#..........###########.......
...#..#.........#.........#.......
...#...#........#.................
...#....#.......#.........#.......
...#.....#......###########.......
..................................
...#############.....#........#...
.........#...........#........#...
.........#...........#........#...
.........#...........#........#...
.........#...........#........#...
.........#...........#........#...
.........#...........#........#...
.........#...........#........#...
.........#...........#........#...
.........#...........#........#...
.........#...........##########...
..................................
..................................
..................................
..................................
..................................
..................................
..................................
..................................